a	b	c	d |	f
------------------------------------
0	0	0	0 |	z
0	0	0	1 |	0
0	0	1	0 |	z
0	0	1	1 |	1
0	1	0	0 |	0
0	1	0	1 |	0
0	1	1	0 |	0
0	1	1	1 |	x
1	0	0	0 |	z
1	0	0	1 |	0
1	0	1	0 |	z
1	0	1	1 |	1
1	1	0	0 |	1
1	1	0	1 |	x
1	1	1	0 |	1
1	1	1	1 |	1
tb_tri_buf.v:20: $finish called at 16 (1s)
